level 4
next_level assets/level_2.map
map
# # # # # # # -1
# 0 0 0 0 0 # -1
# 0 # # # 0 # -1
# 0 # R # 0 # -1
# 0 # K # 0 # -1
# 0 S 0 0 0 D -1
# # # # # # # -2