level 3
next_level assets/level_2.map
next_level assets/level_4.map
map
# # L # # # # -1
# 0 K 0 # R # -1
# 0 # 0 # 0 # -1
# 0 # m 0 0 # -1
# 0 # # # 0 # -1
# S # 0 0 0 # -1
# # # D # # # -2